11111111111111111111111
11111111111111111111111
11ECP00C010100000000011
11000000010100100000011
11000000000000011111111
1100B000000000011111111
1100K000000000100000011
11000C1S1C0000100000011
11111111111111111111111
11111111111111111111111