111111111111
1E0C0K0P0B11
1S0000000001
100000000001
111111111111