11111111111111111111111
11111111111111111111111
11C0P00C010100000000011
11111100010100100000011
11000000000000011111111
11000000000000011111111
11000000000000000000011
11000C101C0000100E00011
11111111111111111111111
11111111111111111111111
