11111111111
1E00C000001
10Q0000C001
1111011CKB1
100CC010P01
11111111111