11111111111111111111111
11111111111111111111111
1100000K000000000000011
110000000B00000S0000011
1100P000000000000000011
1100000000000C0C0C00011
11000000000E00000000011
11000000000000000000011
11000000000000000000011
11000000000000000000011
11000000000000000000011
11000000000000000000011
11111111111111111111111
11111111111111111111111
