11111111111111111111111111111
11111111111101S10111111111111
11000000000K00000K00000001111
11010C010C0000C0C0C0C0C0C1111
11000000000000000000000000011
110000C0000000000000000000011
11000000011111111111111111011
1C0000C0011111111111111111011
1000000C011111111111111111011
1100P0C001111111E111111111011
11000000011111110000000000011
110100C1011111110100010001011
11000000011111110000000000001
1111111111111111B111111111111
11111111111111111111111111111