111111111111111111111111111
1111111111111111111C101C111
111000000B00001111100000111
110000000000C011110K0S0K011
110000111111111111000000011
11000C111111111111100000111
110001111111111111111011111
11000C111111111111111011111
11000011111C010011111011111
11P000000000000E1111100C011
11011111111C010111111000111
11011111111111111111100C011
110111111111111111111011111
110111111111111111111011111
110000000000000000000011111
111111111111111111111111111
111111111111111111111111111
