1111111111111111111111111111111111
10000011000C0000000000000011000001
1000001100000000000000C00011000001
1111111100000000000000000011111111
1111111100011100000000000011111111
100000000001EC0000000C000000000001
1111111100011100000000001111111111
1111111100000000000000001111111111
100000110000P0000000C0001100000001
10000011000000000000000C1100000001
1111111111111111111111111111111111