111111111111111111111111111
111111111111111111101010111
111000000B00001111100000111
1100000000000011110K0S0K011
11000011111111111100C0C0011
110000111111111111100000111
110001111111111111111011111
110000111111111111111C11111
110000111110010011111011111
110000000000000E11111C00011
1101111111100101111110P0111
110111111111111111111000011
110111111111111111111011111
110111111111111111111011111
110000000000000000000011111
111111111111111111111111111
111111111111111111111111111
