111111111111111111111111111
111111111111111111111111111
110000000000B00011111000111
110101111111110111110C0C011
11000111111110S0111110C0111
110001111111100011110000011
110001110000000011111001111
110001110E00000011111001111
110001110001110011111001111
11000111111111000000K00K011
110001111111110000100001011
110001111111110000000000011
1101000000000000000000P0011
110000000000000000100001011
110111111111111110000000011
111111111111111111111111111
111111111111111111111111111
