111111111111111111111111111
111111111111111111111111111
110000000000B000111110S0111
110101111111110011111101111
110001111111110011111000111
110001111111110011111000111
110001110001110011111101111
110001110E00000011111101111
110001110001110011111101111
1100011111111100K000K000011
110001111111110000100001011
110001111111110000000000011
11000000P00C000000000000011
110000000000000000100001011
110111111111111110000000011
111111111111111111111111111
111111111111111111111111111
