111111111111111111111111111111111111111111111111111111111111111111111111
10000000000C000000000000001100000000110000000000000000000000000000000001
1000000000000000000000C0001100000000110000000000000000000000000000000001
11111111C000000000000000000C00000000110000000000110000000000000000000001
11111111C001110000000000000000000000110000000000110000000000000000000001
10C00E0000010C0000000C00000000000000110000000000110000000000000000000001
1111111100011100000000000C0000000000111111111111110000000000000000000001
111111110000000000000000110000000000111111111111110000000000000011111111
100000110000P0000000C000110000000000000000000000000000000000000C11111111
10000011000000000000000C110000000000000000000000000000000000000000000001
111111111111111111111111111111111111111111111111111111111111111111111111