111111111111111111111111111
111111111111111111111111111
1100C0000C0000C0000C0000011
110111111111100111111111011
110111111111100111111111011
110111111111100111111111011
1101111101S1000000011111011
11P1111100000000K0011111011
110000000000000000000000011
110000000000000000011111011
11011111B000000000E11111011
110111111110011111111111011
110111111110011111111111011
110111111110011111111111011
1100C0000C0000C0000C0000011
111111111111111111111111111
111111111111111111111111111
