111111111111111111111111111111111111111111111111111111111111111111111111
100000000000000000000000001100000000000000000000000000000000000000000001
1000000000000000000000C0001101111111111111111111111111111111111111111111
11111111000000000000E000000C01111111111111111111111111111111111111111111
11111111C001110000000000000000000000000000000000000000000011111111111111
1000000000010C0000000C00000000000000000000000000000000000011111111111111
1111111100011100000000000C0001111111111111111111111111111111111111111111
111111110000000000000000110001111111111111111111111111111111111111111111
100000110000P0000000C000110000000000000000000000000000000000000000000001
100000110000000000000000110000000000000000000000000000000000000000000001
111111111111111111111111111111111111111111111111111111111111111111111111