111111111111111111111111111
11111111111E0000000000S0111
111111111111111111110000111
1111111111111111111111C1111
111111111111111111111101111
1111111111111111111111C1111
1100K000K001111111111101111
1101000001011111111111C1111
110000000000000000000000011
110001110001111101111100011
110001110001111101111100011
110001110001111101111100011
11000B00000111100011110P011
110100000101111010111101011
110000000001111000111100011
111111111111111111111111111
111111111111111111111111111
