111111111111111111111111111111111111111111111111111111111111
111111111111111111111111111111111111111111111111111111100011
111000000000000000000000111111110101011111111000000011101011
111001111111111111100000011111110000011111111010001011100011
111001111111111111100000011111100000001111111000000011101111
111001111111111111100000011111001111100001111000000011101111
111001111111111111100000011111001111100001111000000011101111
111001111111111111100000011111001111100000111000000011101111
111001111111111111100000011111001111100000010000000011101111
111000000000000000100001111100111110000000000000001110111111
111101111111111111111000011111001111100000000000000000000111
11110111111111111111100001111100111110000001000000S000010111
111101111111111111110000011111001111100000010000000000000111
110000000000000001110000111111001111100000000000001111111111
110100000100000101110000000000001111100000000000001111111111
1100000P0000000001110000111111001111100000010000001111111111
110000000000000001110000011111000011110001111000001111000111
11110100010001011111000C011111111011110001111000001111101111
111100000000000111110000111111111011110001111000001111030111
111111111111111111111111111111111011110001111111111111101111
111111111111111111111111111111111011110001111111111111000111
111111111111111111111111111111111011110001111111111111000111
111111111111111111111111111000111011110001111111111111000111
1100000000000000000000000000E0111011110000000000000000000111
110111111111111111111111111000111011110000000000000000000111
1101111111111111111111111111111110111100000C00C000C000000111
110111111111111111111111111111111011111000000000000000000111
110111111111111111111111111111111011111111000000B000K0000111
110111010111010111010111010111111011111111000000000000000111
110000000000000000000000000000000011111111000000000000000111
111010111010111010111010111111111111111111111111111111111111
111111111111111111111111111111111111111111111111111111111111
111111111111111111111111111111111111111111111111111111111111
